9 9 9 9 9 9 9 9 9 9 9 9 9 9 9 9 0 0 0 1 0 1 1 0 0 1 9 9 9 9 9 9 9 9 9 9 9 9 9 9 9 9 9 9 9 9 9 9 9 9
9 9 9 9 9 9 9 9 9 9 9 9 9 9 9 9 0 0 0 1 0 1 1 1 0 0 9 9 9 9 9 9 9 9 9 9 9 9 9 9 9 9 9 9 9 9 9 9 9 9
9 9 9 9 9 9 9 9 9 9 9 9 9 9 9 9 0 1 0 1 0 1 1 1 0 0 9 9 9 9 9 9 9 9 9 9 9 9 9 9 9 9 9 9 9 9 9 9 9 9
9 9 9 9 9 9 9 9 9 9 9 9 9 9 9 9 9 0 0 1 0 1 1 1 0 0 9 9 9 9 9 9 9 9 9 9 9 9 9 9 9 9 9 9 9 9 9 9 9 9
9 9 9 9 9 9 9 9 9 9 9 9 9 9 9 9 9 0 0 0 0 0 0 0 0 1 9 9 9 9 9 27 27 27 27 27 27 9 9 9 9 9 9 9 9 9 9 9 9 9
9 9 9 9 9 9 9 9 9 9 9 9 9 9 9 9 9 9 9 0 0 0 0 0 0 0 9 9 9 9 9 27 0 0 0 0 27 9 9 9 9 9 9 9 9 9 9 9 9 9
9 9 9 9 27 27 27 27 27 27 27 27 9 9 9 9 9 9 9 0 0 9 9 9 9 9 9 9 9 9 9 27 0 0 0 0 27 9 9 9 9 9 9 9 9 9 9 9 9 9
9 9 9 9 27 0 0 0 0 0 0 27 9 9 9 9 9 1 1 0 1 9 9 9 9 9 9 9 9 9 9 27 0 0 0 0 27 9 9 9 9 9 9 9 9 9 9 9 9 9
9 9 9 9 27 0 0 0 0 0 0 27 9 9 9 9 1 1 1 0 1 9 9 9 9 9 9 9 9 9 1 27 0 0 0 0 27 9 9 9 9 9 9 9 9 9 9 9 9 9
9 9 9 9 27 0 0 0 0 0 0 27 1 1 1 1 1 1 1 0 1 1 1 1 1 1 1 1 1 1 1 27 0 0 0 0 27 9 9 9 9 9 9 9 9 9 9 9 9 9
9 9 9 9 27 0 0 0 0 0 0 0 0 0 0 0 0 0 0 0 0 0 0 0 0 0 0 0 0 0 0 0 0 0 0 0 27 9 9 9 9 9 9 9 9 9 9 9 9 9
9 9 9 9 27 0 0 0 0 0 0 27 1 1 1 1 1 0 1 1 0 1 1 1 1 1 1 1 1 1 1 27 0 0 0 0 27 9 9 9 9 9 9 9 9 9 9 9 9 9
9 9 9 9 27 0 0 0 0 0 0 27 9 9 9 9 9 0 0 0 0 9 9 9 9 9 9 9 9 9 1 27 0 0 0 0 27 9 9 9 9 9 9 9 9 9 9 9 9 9
9 9 9 9 27 27 27 27 27 27 27 27 9 9 9 9 9 0 1 0 0 9 9 9 9 9 9 9 9 9 9 27 0 0 0 0 27 9 9 9 9 9 9 9 9 9 9 9 9 9
9 9 9 9 9 9 9 9 9 9 9 9 9 9 9 9 9 9 1 0 0 0 0 0 9 9 9 9 9 9 9 27 0 0 0 0 27 9 9 9 9 9 9 9 9 9 9 9 9 9
9 9 9 9 9 9 9 9 9 9 9 9 9 9 9 9 9 9 0 0 0 0 0 9 9 9 9 9 9 9 9 27 27 27 27 27 27 9 9 9 9 9 9 9 9 9 9 9 9 9
9 9 9 9 9 9 9 9 9 9 9 9 9 9 9 9 9 9 0 0 0 0 1 9 9 9 9 9 9 9 9 9 9 9 9 9 9 9 9 9 9 9 9 9 9 9 9 9 9 9
9 9 9 9 9 9 9 9 9 9 9 9 9 9 9 9 9 9 0 1 0 0 9 9 9 9 9 9 9 9 9 9 9 9 9 9 9 9 9 9 9 9 9 9 9 9 9 9 9 9
9 9 9 9 9 9 9 9 9 9 9 9 9 9 9 9 9 9 0 1 0 0 9 9 9 9 9 9 9 9 9 9 9 9 9 9 9 9 9 9 9 9 9 9 9 9 9 9 9 9
9 9 9 9 9 9 9 9 9 9 9 9 9 9 9 9 9 9 0 9 0 0 9 9 9 9 9 9 9 9 9 9 9 9 9 9 9 9 9 9 9 9 9 9 9 9 9 9 9 9
0 0 0 1 0 0 1 0 1 1 0 0 0 0 0 0 0 0 0 1 1 1 1 1 1 1 1 1 1 1 0 0 0 0 0 9 0 27 27 27 27 27 27 27 27 27 27 27 27 27
1 0 0 0 0 1 1 0 0 1 0 0 0 0 0 0 0 0 1 1 27 27 27 27 27 1 1 1 1 1 0 0 0 0 0 9 9 27 0 27 0 27 0 27 0 27 0 27 0 27
1 1 0 0 0 0 1 0 1 0 0 0 0 0 0 0 1 1 1 1 27 0 0 0 27 0 0 0 0 0 0 0 0 0 1 0 0 27 1 1 0 0 0 0 0 0 0 0 0 0
1 1 1 0 1 1 0 0 0 1 0 0 0 0 0 1 1 1 1 1 27 0 0 0 0 0 0 0 0 0 0 0 0 0 1 0 0 27 27 1 0 0 0 27 27 27 27 27 27 27
1 1 1 0 0 0 0 0 0 0 0 0 0 0 0 1 1 1 0 1 27 0 0 0 27 1 0 0 1 1 0 0 0 0 1 0 0 27 0 0 0 0 0 27 0 0 0 0 0 0
0 0 1 0 0 0 0 0 0 0 0 0 0 0 0 1 1 0 0 0 27 0 0 0 27 1 0 0 1 1 0 0 0 0 0 0 0 27 27 0 0 0 0 27 0 0 0 0 0 0
0 0 1 1 0 0 0 0 1 1 1 1 1 1 0 0 1 0 0 0 27 27 27 27 27 0 0 0 1 1 0 0 0 0 0 0 0 27 0 0 0 0 0 27 0 0 0 0 0 0
1 0 0 0 1 0 0 1 1 1 1 1 0 1 1 1 1 1 1 1 1 1 0 1 1 1 0 0 1 1 0 0 0 0 0 0 0 27 27 0 0 0 0 27 0 0 0 0 0 0
1 1 0 1 1 0 0 0 1 1 1 1 0 0 1 1 1 0 0 1 1 1 0 1 1 0 0 0 1 1 0 0 0 0 0 17 18 18 18 18 16 0 0 27 27 27 0 27 27 27
0 0 0 0 0 0 1 0 0 1 1 1 0 0 0 1 1 0 0 0 1 1 0 0 0 0 0 0 1 1 0 0 0 0 0 23 0 27 0 0 14 18 18 18 18 18 0 0 0 0
0 0 0 0 1 1 0 0 0 0 1 1 1 1 0 0 0 0 0 0 0 0 0 0 0 0 0 0 1 1 0 0 0 0 0 23 0 27 0 27 0 27 0 27 0 27 0 27 0 27
0 0 0 0 0 0 0 0 0 0 0 0 0 0 0 0 0 0 0 0 0 0 0 0 0 0 0 0 0 0 0 0 0 0 0 23 0 27 27 27 27 27 27 27 27 27 27 27 27 27
29 29 29 29 29 29 29 29 29 29 29 29 29 29 29 29 29 29 29 29 29 29 29 29 29 29 29 29 29 29 29 29 29 0 0 23 0 1 0 1 0 1 0 1 0 1 0 1 0 1
9 9 9 9 9 9 9 9 9 9 9 9 9 9 9 9 9 9 9 9 9 9 9 9 9 9 9 9 9 9 9 9 9 30 0 14 18 18 18 18 18 18 18 18 18 18 18 18 18 18
9 9 9 9 9 9 9 9 9 9 9 9 9 9 9 9 9 9 9 9 9 9 9 9 9 9 9 9 9 9 9 9 9 30 0 0 0 0 0 0 0 0 0 0 0 0 0 0 0 0
9 9 9 9 9 9 9 9 9 9 9 9 9 9 9 9 9 9 9 9 9 9 9 9 9 9 9 9 9 9 9 9 9 9 29 29 29 29 29 29 29 29 29 29 29 29 29 29 29 29
9 9 9 9 9 9 9 9 9 9 9 9 9 9 9 9 9 9 9 9 9 9 9 9 9 9 9 9 9 9 9 9 9 9 9 9 9 9 9 9 9 9 9 9 9 9 9 9 9 9
9 9 9 9 9 9 9 9 9 9 9 9 9 9 9 9 9 9 9 9 9 9 9 9 9 9 9 9 9 9 9 9 9 9 9 9 9 9 9 9 9 9 9 9 9 9 9 9 9 9
9 9 9 9 9 9 9 9 9 9 9 9 9 9 9 9 9 9 9 9 9 9 9 9 9 9 9 9 9 9 9 9 9 9 9 9 9 9 9 9 9 9 9 9 9 9 9 9 9 9
9 9 9 9 9 9 9 9 9 9 9 9 9 9 9 9 9 9 9 9 9 9 9 9 9 9 9 9 9 9 9 9 9 9 9 9 9 9 9 9 9 9 9 9 9 9 9 9 9 9
9 9 9 9 9 9 9 9 9 9 9 9 9 9 9 9 9 9 9 9 9 9 9 9 9 9 9 9 9 9 9 9 9 9 9 9 9 9 9 9 9 9 9 9 9 9 9 9 9 9
9 9 9 9 9 9 9 9 9 9 9 9 9 9 9 9 9 9 9 9 9 9 9 9 9 9 9 9 9 9 9 9 9 9 9 9 9 9 9 9 9 9 9 9 9 9 9 9 9 9
9 9 9 9 9 9 9 9 9 9 9 9 9 9 9 9 9 9 9 9 9 9 9 9 9 9 9 9 9 9 9 9 9 9 9 9 9 9 9 9 9 9 9 9 9 9 9 9 9 9
9 9 9 9 9 9 9 9 9 9 9 9 9 9 9 9 9 9 9 9 9 9 9 9 9 9 9 9 9 9 9 9 9 9 9 9 9 9 9 9 9 9 9 9 9 9 9 9 9 9
9 9 9 9 9 9 9 9 9 9 9 9 9 9 9 9 9 9 9 9 9 9 9 9 9 9 9 9 9 9 9 9 9 9 9 9 9 9 9 9 9 9 9 9 9 9 9 9 9 9
9 9 9 9 9 9 9 9 9 9 9 9 9 9 9 9 9 9 9 9 9 9 9 9 9 9 9 9 9 9 9 9 9 9 9 9 9 9 9 9 9 9 9 9 9 9 9 9 9 9
9 9 9 9 9 9 9 9 9 9 9 9 9 9 9 9 9 9 9 9 9 9 9 9 9 9 9 9 9 9 9 9 9 9 9 9 9 9 9 9 9 9 9 9 9 9 9 9 9 9
9 9 9 9 9 9 9 9 9 9 9 9 9 9 9 9 9 9 9 9 9 9 9 9 9 9 9 9 9 9 9 9 9 9 9 9 9 9 9 9 9 9 9 9 9 9 9 9 9 9
9 9 9 9 9 9 9 9 9 9 9 9 9 9 9 9 9 9 9 9 9 9 9 9 9 9 9 9 9 9 9 9 9 9 9 9 9 9 9 9 9 9 9 9 9 9 9 9 9 9
9 9 9 9 9 9 9 9 9 9 9 9 9 9 9 9 9 9 9 9 9 9 9 9 9 9 9 9 9 9 9 9 9 9 9 9 9 9 9 9 9 9 9 9 9 9 9 9 9 9

