0009 0009 0009 0009 0009 0009 0009 0009 0009 0009 0009 0009 0009 0009 0009 0009 0000 0000 0000 0001 0000 0001 0001 0000 0000 0001 0009 0009 0009 0009 0009 0009 0009 0009 0009 0009 0009 0009 0009 0009 0009 0009 0009 0009 0009 0009 0009 0009 0009 0009
0009 0009 0009 0009 0009 0009 0009 0009 0009 0009 0009 0009 0009 0009 0009 0009 0000 0000 0000 0001 0000 0001 0001 0001 0000 0000 0009 0009 0009 0009 0009 0009 0009 0009 0009 0009 0009 0009 0009 0009 0009 0009 0009 0009 0009 0009 0009 0009 0009 0009
0009 0009 0009 0009 0009 0009 0009 0009 0009 0009 0009 0009 0009 0009 0009 0009 0000 0001 0000 0001 0000 0001 0001 0001 0000 0000 0009 0009 0009 0009 0009 0009 0009 0009 0009 0009 0009 0009 0009 0009 0009 0009 0009 0009 0009 0009 0009 0009 0009 0009
0009 0009 0009 0009 0009 0009 0009 0009 0009 0009 0009 0009 0009 0009 0009 0009 0009 0000 0000 0001 0000 0001 0001 0001 0000 0000 0009 0009 0009 0009 0009 0009 0009 0009 0009 0009 0009 0009 0009 0009 0009 0009 0009 0009 0009 0009 0009 0009 0009 0009
0009 0009 0009 0009 0009 0009 0009 0009 0009 0009 0009 0009 0009 0009 0009 0009 0009 0000 0000 0000 0000 0000 0000 0000 0000 0001 0009 0009 0009 0009 0009 0027 0027 0027 0027 0027 0027 0009 0009 0009 0009 0009 0009 0009 0009 0009 0009 0009 0009 0009
0009 0009 0009 0009 0009 0009 0009 0009 0009 0009 0009 0009 0009 0009 0009 0009 0009 0009 0009 0000 0000 0000 0000 0000 0000 0000 0009 0009 0009 0009 0009 0027 0033 0033 0033 0033 0027 0009 0009 0009 0009 0009 0009 0009 0009 0009 0009 0009 0009 0009
0009 0009 0009 0009 0027 0027 0027 0027 0027 0027 0027 0027 0009 0009 0009 0009 0009 0009 0009 0000 0000 0009 0009 0009 0009 0009 0009 0009 0009 0009 0009 0027 0033 0033 0033 0033 0027 0009 0009 0009 0009 0009 0009 0009 0009 0009 0009 0009 0009 0009
0009 0009 0009 0009 0027 0033 0033 0033 0033 0033 0033 0027 0009 0009 0009 0009 0009 0001 0001 0000 0001 0009 0009 0009 0009 0009 0009 0009 0009 0009 0009 0027 0033 0033 0033 0033 0027 0009 0009 0009 0009 0009 0009 0009 0009 0009 0009 0009 0009 0009
0009 0009 0009 0009 0027 0033 0034 0035 0034 0035 0035 0027 0009 0009 0009 0009 0001 0001 0001 0000 0001 0009 0009 0009 0009 0009 0009 0009 0009 0009 0001 0027 0033 0033 0033 0033 0027 0009 0009 0009 0009 0009 0009 0009 0009 0009 0009 0009 0009 0009
0009 0009 0009 0009 0027 0033 0033 0033 0033 0033 0033 0027 0001 0001 0001 0001 0001 0001 0001 0000 0001 0001 0001 0001 0001 0001 0001 0001 0001 0001 0001 0027 0033 0033 0033 0033 0027 0009 0009 0009 0009 0009 0009 0009 0009 0009 0009 0009 0009 0009
0009 0009 0009 0009 0027 0033 0033 0033 0033 0033 0033 0033 0000 0000 0000 0000 0000 0000 0000 0000 0000 0000 0000 0000 0000 0000 0000 0000 0000 0000 0000 0033 0033 0033 0033 0033 0027 0009 0009 0009 0009 0009 0009 0009 0009 0009 0009 0009 0009 0009
0009 0009 0009 0009 0027 0036 0033 0033 0033 0033 0037 0027 0001 0001 0001 0001 0001 0000 0001 0001 0000 0001 0001 0001 0001 0001 0001 0001 0001 0001 0001 0027 0033 0033 0033 0033 0027 0009 0009 0009 0009 0009 0009 0009 0009 0009 0009 0009 0009 0009
0009 0009 0009 0009 0027 0033 0033 0033 0033 0033 0033 0027 0009 0009 0009 0009 0009 0000 0000 0000 0000 0009 0009 0009 0009 0009 0009 0009 0009 0009 0001 0027 0033 0033 0033 0033 0027 0009 0009 0009 0009 0009 0009 0009 0009 0009 0009 0009 0009 0009
0009 0009 0009 0009 0027 0027 0027 0027 0027 0027 0027 0027 0009 0009 0009 0009 0009 0000 0001 0000 0000 0009 0009 0009 0009 0009 0009 0009 0009 0009 0009 0027 0033 0033 0033 0033 0027 0009 0009 0009 0009 0009 0009 0009 0009 0009 0009 0009 0009 0009
0009 0009 0009 0009 0009 0009 0009 0009 0009 0009 0009 0009 0009 0009 0009 0009 0009 0009 0001 0000 0000 0000 0000 0000 0009 0009 0009 0009 0009 0009 0009 0027 0033 0033 0033 0033 0027 0009 0009 0009 0009 0009 0009 0009 0009 0009 0009 0009 0009 0009
0009 0009 0009 0009 0009 0009 0009 0009 0009 0009 0009 0009 0009 0009 0009 0009 0009 0009 0000 0000 0000 0000 0000 0009 0009 0009 0009 0009 0009 0009 0009 0027 0027 0027 0027 0027 0027 0009 0009 0009 0009 0009 0009 0009 0009 0009 0009 0009 0009 0009
0009 0009 0009 0009 0009 0009 0009 0009 0009 0009 0009 0009 0009 0009 0009 0009 0009 0009 0000 0000 0000 0000 0001 0009 0009 0009 0009 0009 0009 0009 0009 0009 0009 0009 0009 0009 0009 0009 0009 0009 0009 0009 0009 0009 0009 0009 0009 0009 0009 0009
0009 0009 0009 0009 0009 0009 0009 0009 0009 0009 0009 0009 0009 0009 0009 0009 0009 0009 0000 0001 0000 0000 0009 0009 0009 0009 0009 0009 0009 0009 0009 0009 0009 0009 0009 0009 0009 0009 0009 0009 0009 0009 0009 0009 0009 0009 0009 0009 0009 0009
0009 0009 0009 0009 0009 0009 0009 0009 0009 0009 0009 0009 0009 0009 0009 0009 0009 0009 0000 0001 0000 0000 0009 0009 0009 0009 0009 0009 0009 0009 0009 0009 0009 0009 0009 0009 0009 0009 0009 0009 0009 0009 0009 0009 0009 0009 0009 0009 0009 0009
0009 0009 0009 0009 0009 0009 0009 0009 0009 0009 0009 0009 0009 0009 0009 0009 0009 0009 0000 0000 0000 0000 0009 0009 0009 0009 0009 0009 0009 0009 0009 0009 0009 0009 0009 0009 0009 0009 0009 0009 0009 0009 0009 0009 0009 0009 0009 0009 0009 0009
0000 0000 0000 0001 0000 0000 0001 0000 0001 0001 0000 0000 0000 0000 0000 0000 0000 0000 0000 0001 0001 0001 0001 0001 0001 0001 0001 0001 0001 0001 0000 0000 0000 0000 0000 0009 0000 0027 0027 0027 0027 0027 0027 0027 0027 0027 0027 0027 0027 0027
0001 0000 0000 0000 0000 0001 0001 0000 0000 0001 0000 0000 0000 0000 0000 0000 0000 0000 0001 0001 0027 0027 0027 0027 0027 0001 0001 0001 0001 0001 0000 0000 0000 0000 0000 0009 0009 0027 0000 0027 0000 0027 0000 0027 0000 0027 0000 0027 0000 0027
0001 0001 0000 0000 0000 0000 0001 0000 0001 0000 0000 0000 0000 0000 0000 0000 0001 0001 0001 0001 0027 0033 0033 0033 0027 0000 0000 0000 0000 0000 0000 0000 0000 0000 0001 0000 0000 0027 0001 0001 0000 0000 0000 0000 0000 0000 0000 0000 0000 0000
0001 0001 0001 0000 0001 0001 0000 0000 0000 0001 0000 0000 0000 0000 0000 0001 0001 0001 0001 0001 0027 0033 0033 0033 0033 0000 0000 0000 0000 0000 0000 0000 0000 0000 0001 0000 0000 0027 0027 0001 0000 0000 0000 0027 0027 0027 0027 0027 0027 0027
0001 0001 0001 0000 0000 0000 0000 0000 0000 0000 0000 0000 0000 0000 0000 0001 0001 0001 0000 0001 0027 0033 0033 0033 0027 0001 0000 0000 0001 0001 0000 0000 0000 0000 0001 0000 0000 0027 0000 0000 0000 0000 0000 0027 0033 0033 0033 0033 0033 0033
0000 0000 0001 0000 0000 0000 0000 0000 0000 0000 0000 0000 0000 0000 0000 0001 0001 0000 0000 0000 0027 0033 0033 0033 0027 0001 0000 0000 0001 0001 0000 0000 0000 0000 0000 0000 0000 0027 0027 0000 0000 0000 0000 0027 0033 0033 0033 0033 0033 0033
0000 0000 0001 0001 0000 0000 0000 0000 0001 0001 0001 0001 0001 0001 0000 0000 0001 0000 0000 0000 0027 0027 0027 0027 0027 0000 0000 0000 0001 0001 0000 0000 0000 0000 0000 0000 0000 0027 0000 0000 0000 0000 0000 0027 0033 0033 0033 0033 0033 0033
0001 0000 0000 0000 0001 0000 0000 0001 0001 0001 0001 0001 0000 0001 0001 0001 0001 0001 0001 0001 0001 0001 0000 0001 0001 0001 0000 0000 0001 0001 0000 0000 0000 0000 0000 0000 0000 0027 0027 0000 0000 0000 0000 0027 0033 0033 0033 0033 0033 0033
0001 0001 0000 0001 0001 0000 0000 0000 0001 0001 0001 0001 0000 0000 0001 0001 0001 0000 0000 0001 0001 0001 0000 0001 0001 0000 0000 0000 0001 0001 0000 0000 0000 0000 0000 0017 0018 0018 0018 0018 0016 0000 0000 0027 0027 0027 0033 0027 0027 0027
0000 0000 0000 0000 0000 0000 0001 0000 0000 0001 0001 0001 0000 0000 0000 0001 0001 0000 0000 0000 0001 0001 0000 0000 0000 0000 0000 0000 0001 0001 0000 0000 0000 0000 0000 0023 0000 0027 0000 0000 0014 0018 0018 0018 0018 0018 0000 0000 0000 0000
0000 0000 0000 0000 0001 0001 0000 0000 0000 0000 0001 0001 0001 0001 0000 0000 0000 0000 0000 0000 0000 0000 0000 0000 0000 0000 0000 0000 0001 0001 0000 0000 0000 0000 0000 0023 0000 0027 0000 0027 0000 0027 0000 0027 0000 0027 0000 0027 0000 0027
0000 0000 0000 0000 0000 0000 0000 0000 0000 0000 0000 0000 0000 0000 0000 0000 0000 0027 0027 0033 0033 0027 0027 0000 0000 0000 0000 0000 0000 0000 0000 0000 0000 0000 0000 0023 0000 0027 0027 0027 0027 0027 0027 0027 0027 0027 0027 0027 0027 0027
0029 0029 0029 0029 0029 0029 0029 0029 0029 0029 0029 0029 0029 0029 0029 0029 0029 0027 0027 0033 0033 0027 0027 0029 0029 0029 0029 0029 0029 0029 0029 0029 0029 0000 0000 0023 0000 0001 0000 0001 0000 0001 0000 0001 0000 0001 0000 0001 0000 0001
0009 0009 0009 0009 0009 0009 0009 0009 0009 0009 0009 0009 0009 0009 0009 0009 0009 0027 0033 0033 0033 0033 0027 0009 0009 0009 0009 0009 0009 0009 0009 0009 0009 0030 0000 0014 0018 0018 0018 0018 0018 0018 0018 0018 0018 0018 0018 0018 0018 0018
0027 0009 0027 0009 0027 0009 0027 0009 0009 0009 0009 0009 0027 0027 0027 0027 0027 0027 0027 0033 0033 0027 0027 0009 0009 0009 0009 0009 0009 0009 0009 0009 0009 0030 0000 0000 0000 0000 0000 0000 0000 0000 0000 0000 0000 0000 0000 0000 0000 0000
0027 0027 0027 0027 0027 0027 0027 0009 0009 0009 0009 0009 0027 0033 0033 0033 0033 0027 0033 0033 0033 0033 0027 0009 0009 0009 0009 0009 0009 0009 0009 0009 0009 0009 0029 0029 0029 0029 0029 0029 0029 0029 0029 0029 0029 0029 0029 0029 0029 0029
0027 0034 0034 0034 0034 0034 0027 0009 0009 0009 0009 0009 0027 0033 0033 0033 0033 0027 0027 0033 0033 0027 0027 0009 0009 0009 0009 0009 0009 0009 0009 0009 0009 0009 0009 0009 0009 0009 0009 0009 0009 0009 0009 0009 0009 0009 0009 0009 0009 0009
0027 0034 0034 0034 0034 0034 0027 0009 0009 0009 0009 0009 0027 0033 0033 0033 0033 0027 0033 0033 0033 0033 0027 0009 0009 0009 0009 0009 0009 0009 0009 0009 0009 0009 0009 0009 0009 0009 0009 0009 0009 0009 0009 0009 0009 0009 0009 0009 0009 0009
0027 0034 0027 0027 0027 0027 0027 0027 0027 0027 0027 0027 0027 0033 0027 0027 0027 0027 0027 0033 0033 0027 0027 0027 0027 0027 0009 0009 0009 0009 0009 0009 0009 0009 0009 0009 0009 0009 0009 0009 0009 0009 0009 0009 0009 0009 0009 0009 0009 0009
0027 0033 0033 0033 0033 0033 0033 0033 0033 0033 0033 0027 0027 0033 0027 0009 0009 0027 0033 0033 0033 0033 0027 0033 0033 0027 0009 0009 0009 0009 0009 0009 0009 0009 0009 0009 0009 0009 0009 0009 0009 0009 0009 0009 0009 0009 0009 0009 0009 0009
0027 0033 0027 0027 0027 0033 0027 0027 0027 0027 0033 0033 0033 0033 0027 0027 0027 0027 0033 0033 0033 0033 0033 0033 0033 0027 0009 0009 0009 0009 0009 0009 0009 0009 0009 0009 0009 0009 0009 0009 0009 0009 0009 0009 0009 0009 0009 0009 0009 0009
0027 0033 0027 0001 0000 0000 0000 0001 0001 0027 0033 0027 0027 0033 0033 0033 0033 0033 0033 0033 0033 0033 0027 0033 0033 0027 0009 0009 0009 0009 0009 0009 0009 0009 0009 0009 0009 0009 0009 0009 0009 0009 0009 0009 0009 0009 0009 0009 0009 0009
0027 0033 0027 0000 0000 0001 0000 0000 0000 0027 0033 0027 0033 0033 0027 0027 0027 0027 0033 0033 0033 0033 0027 0033 0033 0027 0009 0009 0009 0009 0009 0009 0009 0009 0009 0009 0009 0009 0009 0009 0009 0009 0009 0009 0009 0009 0009 0009 0009 0009
0027 0033 0027 0000 0000 0000 0000 0001 0000 0027 0033 0027 0027 0033 0027 0001 0001 0027 0027 0033 0027 0027 0027 0027 0027 0027 0009 0009 0009 0009 0009 0009 0009 0009 0009 0009 0009 0009 0009 0009 0009 0009 0009 0009 0009 0009 0009 0009 0009 0009
0027 0033 0027 0001 0000 0001 0000 0001 0000 0027 0033 0027 0033 0033 0027 0001 0001 0027 0033 0033 0033 0033 0027 0009 0009 0009 0009 0009 0009 0009 0009 0009 0009 0009 0009 0009 0009 0009 0009 0009 0009 0009 0009 0009 0009 0009 0009 0009 0009 0009
0027 0033 0027 0000 0000 0000 0000 0000 0000 0027 0033 0027 0033 0033 0027 0001 0001 0027 0033 0033 0033 0033 0027 0009 0009 0009 0009 0009 0009 0009 0009 0009 0009 0009 0009 0009 0009 0009 0009 0009 0009 0009 0009 0009 0009 0009 0009 0009 0009 0009
0027 0033 0027 0001 0000 0001 0000 0001 0000 0027 0033 0027 0033 0033 0027 0001 0001 0027 0033 0033 0033 0033 0027 0009 0009 0009 0009 0009 0009 0009 0009 0009 0009 0009 0009 0009 0009 0009 0009 0009 0009 0009 0009 0009 0009 0009 0009 0009 0009 0009
0027 0033 0027 0027 0027 0027 0027 0027 0027 0027 0033 0027 0033 0033 0027 0001 0001 0027 0033 0033 0033 0033 0027 0009 0009 0009 0009 0009 0009 0009 0009 0009 0009 0009 0009 0009 0009 0009 0009 0009 0009 0009 0009 0009 0009 0009 0009 0009 0009 0009
0027 0033 0033 0033 0033 0033 0033 0033 0033 0027 0033 0027 0027 0027 0027 0001 0001 0027 0033 0033 0033 0033 0027 0009 0009 0009 0009 0009 0009 0009 0009 0009 0009 0009 0009 0009 0009 0009 0009 0009 0009 0009 0009 0009 0009 0009 0009 0009 0009 0009
0027 0027 0027 0027 0027 0027 0027 0027 0027 0027 0033 0033 0033 0033 0027 0001 0001 0027 0027 0027 0027 0027 0027 0009 0009 0009 0009 0009 0009 0009 0009 0009 0009 0009 0009 0009 0009 0009 0009 0009 0009 0009 0009 0009 0009 0009 0009 0009 0009 0009

