0001 0001 0001 0001 0009 0009 0009 0009 0009 0009 0009 0009 0009 0009 0009 0009 0009 0009 0001 0001 0001 0000 0000 0000 0000 0001 0000 0000 0000 0009 0009 0009 0009 0009 0009 0009 0009 0009 0009 0009 0009 0009 0009 0000 0000 0000 0000 0000 0000 0000
0001 0000 0000 0001 0001 0009 0009 0001 0000 0009 0009 0009 0009 0009 0009 0009 0009 0001 0001 0001 0001 0000 0000 0001 0000 0001 0000 0000 0000 0009 0009 0009 0009 0009 0009 0009 0009 0009 0009 0009 0009 0009 0009 0000 0000 0000 0000 0000 0000 0000 
0001 0000 0000 0000 0001 0001 0009 0001 0000 0001 0001 0001 0009 0000 0025 0025 0025 0025 0025 0001 0001 0001 0000 0000 0000 0000 0000 0000 0000 0000 0009 0009 0009 0009 0009 0009 0009 0009 0009 0009 0009 0009 0009 0009 0000 0000 0000 0000 0000 0000 
0001 0000 0025 0025 0025 0025 0025 0025 0025 0000 0000 0000 0001 0000 0025 0000 0000 0000 0025 0000 0001 0000 0000 0001 0000 0001 0000 0000 0000 0000 0000 0009 0009 0009 0009 0009 0009 0009 0009 0009 0009 0009 0009 0009 0009 0000 0000 0000 0000 0000 
0001 0000 0025 0000 0000 0000 0000 0000 0025 0000 0000 0000 0000 0000 0025 0000 0000 0000 0025 0000 0000 0001 0000 0000 0000 0000 0000 0000 0000 0000 0000 0009 0009 0009 0009 0009 0009 0009 0009 0009 0009 0009 0009 0009 0009 0000 0000 0000 0000 0000 
0001 0000 0025 0000 0000 0000 0000 0000 0025 0000 0000 0000 0000 0000 0025 0000 0000 0000 0025 0000 0000 0000 0001 0000 0000 0001 0000 0000 0000 0000 0000 0009 0009 0009 0009 0009 0009 0009 0009 0009 0009 0009 0009 0009 0009 0000 0000 0000 0000 0000 
0001 0000 0025 0000 0000 0000 0000 0000 0025 0000 0000 0000 0000 0000 0025 0000 0000 0000 0025 0000 0001 0000 0000 0000 0000 0000 0001 0000 0000 0000 0000 0009 0009 0009 0009 0009 0009 0009 0009 0009 0009 0009 0009 0009 0009 0000 0000 0000 0000 0000
0001 0000 0025 0025 0025 0000 0025 0025 0025 0000 0000 0000 0000 0000 0025 0025 0000 0025 0025 0000 0001 0000 0001 0000 0000 0000 0000 0000 0000 0000 0000 0000 0009 0009 0009 0009 0009 0009 0009 0009 0009 0009 0009 0009 0009 0009 0000 0000 0000 0000 
0001 0000 0001 0001 0001 0000 0001 0001 0001 0000 0000 0000 0000 0000 0000 0000 0000 0000 0000 0001 0001 0000 0000 0000 0000 0000 0001 0000 0000 0000 0000 0000 0009 0009 0009 0009 0009 0009 0009 0009 0009 0009 0009 0009 0009 0009 0000 0000 0000 0000 
0001 0000 0000 0000 0000 0000 0000 0000 0000 0000 0000 0000 0000 0000 0000 0000 0000 0000 0000 0000 0001 0000 0000 0000 0000 0000 0000 0000 0000 0000 0000 0000 0009 0009 0009 0009 0009 0009 0009 0009 0009 0009 0009 0009 0009 0009 0000 0000 0000 0000 
0001 0000 0000 0000 0000 0000 0000 0000 0000 0000 0000 0025 0025 0000 0025 0025 0025 0000 0000 0000 0001 0000 0001 0001 0000 0000 0000 0000 0000 0000 0000 0000 0009 0009 0009 0009 0009 0009 0009 0009 0009 0009 0009 0009 0009 0009 0000 0000 0000 0000 
0001 0000 0025 0025 0025 0000 0025 0025 0025 0000 0000 0025 0000 0000 0000 0000 0025 0000 0000 0001 0000 0000 0000 0000 0000 0000 0000 0000 0001 0000 0000 0000 0009 0009 0009 0009 0009 0009 0009 0009 0009 0009 0009 0009 0009 0009 0009 0000 0000 0000 
0001 0000 0025 0000 0000 0000 0000 0000 0025 0000 0000 0025 0000 0000 0000 0000 0025 0000 0000 0000 0000 0000 0000 0000 0001 0000 0001 0000 0000 0000 0009 0000 0009 0009 0009 0009 0009 0009 0009 0009 0009 0009 0009 0009 0009 0009 0009 0000 0000 0000 
0001 0000 0025 0000 0000 0000 0000 0000 0025 0000 0000 0025 0000 0000 0000 0000 0025 0000 0000 0001 0000 0001 0001 0000 0000 0000 0000 0000 0000 0000 0000 0009 0009 0009 0009 0009 0009 0009 0009 0009 0009 0009 0009 0009 0009 0009 0009 0000 0000 0000 
0001 0000 0025 0000 0000 0000 0000 0000 0025 0000 0000 0025 0000 0000 0000 0000 0025 0000 0000 0001 0000 0000 0000 0000 0000 0000 0000 0000 0000 0000 0000 0009 0009 0009 0009 0009 0009 0009 0009 0009 0009 0009 0009 0009 0009 0009 0009 0000 0000 0000 
0001 0000 0025 0000 0000 0000 0000 0000 0025 0000 0000 0025 0000 0000 0000 0000 0025 0000 0000 0001 0000 0000 0000 0000 0000 0000 0000 0000 0000 0000 0000 0009 0009 0009 0009 0009 0009 0009 0009 0009 0009 0009 0009 0009 0009 0009 0009 0000 0000 0000 
0001 0000 0025 0025 0025 0025 0025 0025 0025 0000 0000 0025 0025 0025 0025 0025 0025 0000 0000 0001 0000 0000 0000 0000 0000 0000 0000 0000 0009 0009 0000 0009 0009 0009 0009 0009 0009 0009 0009 0009 0009 0009 0009 0009 0009 0009 0009 0000 0000 0000
0001 0001 0001 0001 0001 0001 0001 0001 0001 0001 0001 0001 0001 0001 0001 0001 0001 0001 0001 0001 0000 0000 0001 0000 0000 0000 0000 0000 0009 0009 0000 0000 0009 0009 0009 0009 0009 0009 0009 0009 0009 0009 0009 0009 0009 0009 0009 0000 0000 0000
0001 0001 0001 0001 0001 0001 0001 0001 0001 0001 0001 0001 0001 0001 0001 0001 0001 0001 0001 0001 0000 0000 0000 0000 0000 0000 0000 0000 0009 0009 0000 0000 0009 0009 0009 0009 0009 0009 0009 0009 0009 0009 0009 0009 0009 0009 0009 0000 0000 0000
0001 0001 0001 0001 0001 0001 0001 0001 0001 0001 0001 0001 0001 0001 0001 0001 0001 0001 0001 0001 0000 0001 0000 0000 0000 0000 0000 0000 0009 0009 0009 0009 0009 0009 0009 0009 0000 0000 0000 0000 0000 0000 0000 0000 0000 0000 0000 0000 0000 0000
0029 0029 0029 0029 0029 0029 0029 0029 0029 0029 0029 0029 0029 0029 0029 0029 0029 0029 0029 0029 0029 0029 0029 0029 0029 0029 0029 0029 0009 0009 0000 0000 0000 0000 0000 0000 0000 0000 0000 0000 0000 0000 0000 0000 0000 0000 0000 0000 0000 0000
0009 0009 0009 0009 0009 0009 0009 0009 0009 0009 0009 0009 0009 0009 0009 0009 0009 0009 0009 0009 0009 0009 0009 0009 0009 0009 0009 0009 0009 0009 0000 0000 0000 0000 0000 0000 0000 0000 0000 0000 0000 0000 0000 0000 0000 0000 0000 0000 0000 0000
0009 0009 0009 0009 0009 0009 0009 0009 0009 0009 0009 0009 0009 0009 0009 0009 0009 0009 0009 0009 0009 0009 0009 0009 0009 0009 0009 0009 0009 0009 0000 0000 0000 0000 0000 0000 0000 0000 0000 0000 0000 0000 0000 0000 0000 0000 0000 0000 0000 0000
0031 0031 0031 0031 0031 0031 0031 0031 0031 0031 0031 0031 0031 0031 0031 0031 0031 0031 0031 0031 0031 0031 0031 0031 0031 0031 0031 0031 0009 0009 0000 0000 0000 0000 0000 0000 0000 0000 0000 0000 0000 0000 0000 0000 0000 0000 0000 0000 0000 0000
0000 0000 0000 0000 0000 0000 0000 0000 0000 0000 0000 0000 0000 0000 0000 0000 0000 0000 0000 0000 0000 0000 0000 0000 0000 0000 0000 0000 0009 0009 0000 0000 0000 0000 0000 0000 0000 0000 0000 0000 0000 0000 0000 0000 0000 0000 0000 0000 0000 0000
0000 0000 0000 0000 0000 0000 0000 0000 0000 0000 0000 0000 0000 0000 0000 0000 0000 0000 0000 0000 0000 0000 0000 0000 0000 0000 0000 0000 0009 0009 0000 0000 0000 0000 0000 0000 0000 0000 0000 0000 0000 0000 0000 0000 0000 0000 0000 0000 0000 0000
0000 0000 0000 0000 0000 0000 0000 0000 0000 0000 0000 0000 0000 0000 0000 0000 0000 0000 0000 0000 0000 0000 0000 0000 0000 0000 0000 0000 0009 0009 0000 0000 0000 0000 0000 0000 0000 0000 0000 0000 0000 0000 0000 0000 0000 0000 0000 0000 0000 0000
0000 0000 0000 0000 0000 0000 0000 0000 0000 0000 0000 0000 0000 0000 0000 0000 0000 0000 0000 0000 0000 0000 0000 0000 0000 0000 0000 0000 0009 0009 0000 0000 0000 0000 0000 0000 0000 0000 0000 0000 0000 0000 0000 0000 0000 0000 0000 0000 0000 0000
0000 0000 0000 0000 0000 0000 0000 0000 0000 0000 0000 0000 0000 0000 0000 0000 0000 0000 0000 0000 0000 0000 0000 0000 0000 0000 0000 0000 0000 0000 0000 0000 0000 0000 0000 0000 0000 0000 0000 0000 0000 0000 0000 0000 0000 0000 0000 0000 0000 0000
0000 0000 0000 0000 0000 0000 0000 0000 0000 0000 0000 0000 0000 0000 0000 0000 0000 0000 0000 0000 0000 0000 0000 0000 0000 0000 0000 0000 0000 0000 0000 0000 0000 0000 0000 0000 0000 0000 0000 0000 0000 0000 0000 0000 0000 0000 0000 0000 0000 0000
0000 0000 0000 0000 0000 0000 0000 0000 0000 0000 0000 0000 0000 0000 0000 0000 0000 0000 0000 0000 0000 0000 0000 0000 0000 0000 0000 0000 0000 0000 0000 0000 0000 0000 0000 0000 0000 0000 0000 0000 0000 0000 0000 0000 0000 0000 0000 0000 0000 0000
0000 0000 0000 0000 0000 0000 0000 0000 0000 0000 0000 0000 0000 0000 0000 0000 0000 0000 0000 0000 0000 0000 0000 0000 0000 0000 0000 0000 0000 0000 0000 0000 0000 0000 0000 0000 0000 0000 0000 0000 0000 0000 0000 0000 0000 0000 0000 0000 0000 0000
0000 0000 0000 0000 0000 0000 0000 0000 0000 0000 0000 0000 0000 0000 0000 0000 0000 0000 0000 0000 0000 0000 0000 0000 0000 0000 0000 0000 0000 0000 0000 0000 0000 0000 0000 0000 0000 0000 0000 0000 0000 0000 0000 0000 0000 0000 0000 0000 0000 0000
0000 0000 0000 0000 0000 0000 0000 0000 0000 0000 0000 0000 0000 0000 0000 0000 0000 0000 0000 0000 0000 0000 0000 0000 0000 0000 0000 0000 0000 0000 0000 0000 0000 0000 0000 0000 0000 0000 0000 0000 0000 0000 0000 0000 0000 0000 0000 0000 0000 0000
0000 0000 0000 0000 0000 0000 0000 0000 0000 0000 0000 0000 0000 0000 0000 0000 0000 0000 0000 0000 0000 0000 0000 0000 0000 0000 0000 0000 0000 0000 0000 0000 0000 0000 0000 0000 0000 0000 0000 0000 0000 0000 0000 0000 0000 0000 0000 0000 0000 0000
0000 0000 0000 0000 0000 0000 0000 0000 0000 0000 0000 0000 0000 0000 0000 0000 0000 0000 0000 0000 0000 0000 0000 0000 0000 0000 0000 0000 0000 0000 0000 0000 0000 0000 0000 0000 0000 0000 0000 0000 0000 0000 0000 0000 0000 0000 0000 0000 0000 0000
0000 0000 0000 0000 0000 0000 0000 0000 0000 0000 0000 0000 0000 0000 0000 0000 0000 0000 0000 0000 0000 0000 0000 0000 0000 0000 0000 0000 0000 0000 0000 0000 0000 0000 0000 0000 0000 0000 0000 0000 0000 0000 0000 0000 0000 0000 0000 0000 0000 0000
0000 0000 0000 0000 0000 0000 0000 0000 0000 0000 0000 0000 0000 0000 0000 0000 0000 0000 0000 0000 0000 0000 0000 0000 0000 0000 0000 0000 0000 0000 0000 0000 0000 0000 0000 0000 0000 0000 0000 0000 0000 0000 0000 0000 0000 0000 0000 0000 0000 0000
0000 0000 0000 0000 0000 0000 0000 0000 0000 0000 0000 0000 0000 0000 0000 0000 0000 0000 0000 0000 0000 0000 0000 0000 0000 0000 0000 0000 0000 0000 0000 0000 0000 0000 0000 0000 0000 0000 0000 0000 0000 0000 0000 0000 0000 0000 0000 0000 0000 0000
0000 0000 0000 0000 0000 0000 0000 0000 0000 0000 0000 0000 0000 0000 0000 0000 0000 0000 0000 0000 0000 0000 0000 0000 0000 0000 0000 0000 0000 0000 0000 0000 0000 0000 0000 0000 0000 0000 0000 0000 0000 0000 0000 0000 0000 0000 0000 0000 0000 0000
0000 0000 0000 0000 0000 0000 0000 0000 0000 0000 0000 0000 0000 0000 0000 0000 0000 0000 0000 0000 0000 0000 0000 0000 0000 0000 0000 0000 0000 0000 0000 0000 0000 0000 0000 0000 0000 0000 0000 0000 0000 0000 0000 0000 0000 0000 0000 0000 0000 0000
0000 0000 0000 0000 0000 0000 0000 0000 0000 0000 0000 0000 0000 0000 0000 0000 0000 0000 0000 0000 0000 0000 0000 0000 0000 0000 0000 0000 0000 0000 0000 0000 0000 0000 0000 0000 0000 0000 0000 0000 0000 0000 0000 0000 0000 0000 0000 0000 0000 0000
0000 0000 0000 0000 0000 0000 0000 0000 0000 0000 0000 0000 0000 0000 0000 0000 0000 0000 0000 0000 0000 0000 0000 0000 0000 0000 0000 0000 0000 0000 0000 0000 0000 0000 0000 0000 0000 0000 0000 0000 0000 0000 0000 0000 0000 0000 0000 0000 0000 0000
0000 0000 0000 0000 0000 0000 0000 0000 0000 0000 0000 0000 0000 0000 0000 0000 0000 0000 0000 0000 0000 0000 0000 0000 0000 0000 0000 0000 0000 0000 0000 0000 0000 0000 0000 0000 0000 0000 0000 0000 0000 0000 0000 0000 0000 0000 0000 0000 0000 0000
0000 0000 0000 0000 0000 0000 0000 0000 0000 0000 0000 0000 0000 0000 0000 0000 0000 0000 0000 0000 0000 0000 0000 0000 0000 0000 0000 0000 0000 0000 0000 0000 0000 0000 0000 0000 0000 0000 0000 0000 0000 0000 0000 0000 0000 0000 0000 0000 0000 0000
0000 0000 0000 0000 0000 0000 0000 0000 0000 0000 0000 0000 0000 0000 0000 0000 0000 0000 0000 0000 0000 0000 0000 0000 0000 0000 0000 0000 0000 0000 0000 0000 0000 0000 0000 0000 0000 0000 0000 0000 0000 0000 0000 0000 0000 0000 0000 0000 0000 0000
0000 0000 0000 0000 0000 0000 0000 0000 0000 0000 0000 0000 0000 0000 0000 0000 0000 0000 0000 0000 0000 0000 0000 0000 0000 0000 0000 0000 0000 0000 0000 0000 0000 0000 0000 0000 0000 0000 0000 0000 0000 0000 0000 0000 0000 0000 0000 0000 0000 0000
0000 0000 0000 0000 0000 0000 0000 0000 0000 0000 0000 0000 0000 0000 0000 0000 0000 0000 0000 0000 0000 0000 0000 0000 0000 0000 0000 0000 0000 0000 0000 0000 0000 0000 0000 0000 0000 0000 0000 0000 0000 0000 0000 0000 0000 0000 0000 0000 0000 0000
0000 0000 0000 0000 0000 0000 0000 0000 0000 0000 0000 0000 0000 0000 0000 0000 0000 0000 0000 0000 0000 0000 0000 0000 0000 0000 0000 0000 0000 0000 0000 0000 0000 0000 0000 0000 0000 0000 0000 0000 0000 0000 0000 0000 0000 0000 0000 0000 0000 0000
0000 0000 0000 0000 0000 0000 0000 0000 0000 0000 0000 0000 0000 0000 0000 0000 0000 0000 0000 0000 0000 0000 0000 0000 0000 0000 0000 0000 0000 0000 0000 0000 0000 0000 0000 0000 0000 0000 0000 0000 0000 0000 0000 0000 0000 0000 0000 0000 0000 0000
