0009 0009 0009 0009 0009 0009 0009 0009 0009 0009 0009 0009 0009 0009 0009 0009 0000 0000 0000 0001 0000 0001 0001 0000 0000 0001 0009 0009 0009 0009 0009 0009 0009 0009 0009 0009 0009 0009 0009 0009 0009 0009 0009 0009 0009 0009 0009 0009 0009 0009
0009 0009 0009 0009 0009 0009 0009 0009 0009 0009 0009 0009 0009 0009 0009 0009 0000 0000 0000 0001 0000 0001 0001 0001 0000 0000 0009 0009 0009 0009 0009 0009 0009 0009 0009 0009 0009 0009 0009 0009 0009 0009 0009 0009 0009 0009 0009 0009 0009 0009
0009 0009 0009 0009 0009 0009 0009 0009 0009 0009 0009 0009 0009 0009 0009 0009 0000 0001 0000 0001 0000 0001 0001 0001 0000 0000 0009 0009 0009 0009 0009 0009 0009 0009 0009 0009 0009 0009 0009 0009 0009 0009 0009 0009 0009 0009 0009 0009 0009 0009
0009 0009 0009 0009 0009 0009 0009 0009 0009 0009 0009 0009 0009 0009 0009 0009 0009 0000 0000 0001 0000 0001 0001 0001 0000 0000 0009 0009 0009 0009 0009 0009 0009 0009 0009 0009 0009 0009 0009 0009 0009 0009 0009 0009 0009 0009 0009 0009 0009 0009
0009 0009 0009 0009 0009 0009 0009 0009 0009 0009 0009 0009 0009 0009 0009 0009 0009 0000 0000 0000 0000 0000 0000 0000 0000 0001 0009 0009 0009 0009 0009 0027 0027 0027 0027 0027 0027 0009 0009 0009 0009 0009 0009 0009 0009 0009 0009 0009 0009 0009
0009 0009 0009 0009 0009 0009 0009 0009 0009 0009 0009 0009 0009 0009 0009 0009 0009 0009 0009 0000 0000 0000 0000 0000 0000 0000 0009 0009 0009 0009 0009 0027 0000 0000 0000 0000 0027 0009 0009 0009 0009 0009 0009 0009 0009 0009 0009 0009 0009 0009
0009 0009 0009 0009 0027 0027 0027 0027 0027 0027 0027 0027 0009 0009 0009 0009 0009 0009 0009 0000 0000 0009 0009 0009 0009 0009 0009 0009 0009 0009 0009 0027 0000 0000 0000 0000 0027 0009 0009 0009 0009 0009 0009 0009 0009 0009 0009 0009 0009 0009
0009 0009 0009 0009 0027 0000 0000 0000 0000 0000 0000 0027 0009 0009 0009 0009 0009 0001 0001 0000 0001 0009 0009 0009 0009 0009 0009 0009 0009 0009 0009 0027 0000 0000 0000 0000 0027 0009 0009 0009 0009 0009 0009 0009 0009 0009 0009 0009 0009 0009
0009 0009 0009 0009 0027 0000 0000 0000 0000 0000 0000 0027 0009 0009 0009 0009 0001 0001 0001 0000 0001 0009 0009 0009 0009 0009 0009 0009 0009 0009 0001 0027 0000 0000 0000 0000 0027 0009 0009 0009 0009 0009 0009 0009 0009 0009 0009 0009 0009 0009
0009 0009 0009 0009 0027 0000 0000 0000 0000 0000 0000 0027 0001 0001 0001 0001 0001 0001 0001 0000 0001 0001 0001 0001 0001 0001 0001 0001 0001 0001 0001 0027 0000 0000 0000 0000 0027 0009 0009 0009 0009 0009 0009 0009 0009 0009 0009 0009 0009 0009
0009 0009 0009 0009 0027 0000 0000 0000 0000 0000 0000 0000 0000 0000 0000 0000 0000 0000 0000 0000 0000 0000 0000 0000 0000 0000 0000 0000 0000 0000 0000 0000 0000 0000 0000 0000 0027 0009 0009 0009 0009 0009 0009 0009 0009 0009 0009 0009 0009 0009
0009 0009 0009 0009 0027 0000 0000 0000 0000 0000 0000 0027 0001 0001 0001 0001 0001 0000 0001 0001 0000 0001 0001 0001 0001 0001 0001 0001 0001 0001 0001 0027 0000 0000 0000 0000 0027 0009 0009 0009 0009 0009 0009 0009 0009 0009 0009 0009 0009 0009
0009 0009 0009 0009 0027 0000 0000 0000 0000 0000 0000 0027 0009 0009 0009 0009 0009 0000 0000 0000 0000 0009 0009 0009 0009 0009 0009 0009 0009 0009 0001 0027 0000 0000 0000 0000 0027 0009 0009 0009 0009 0009 0009 0009 0009 0009 0009 0009 0009 0009
0009 0009 0009 0009 0027 0027 0027 0027 0027 0027 0027 0027 0009 0009 0009 0009 0009 0000 0001 0000 0000 0009 0009 0009 0009 0009 0009 0009 0009 0009 0009 0027 0000 0000 0000 0000 0027 0009 0009 0009 0009 0009 0009 0009 0009 0009 0009 0009 0009 0009
0009 0009 0009 0009 0009 0009 0009 0009 0009 0009 0009 0009 0009 0009 0009 0009 0009 0009 0001 0000 0000 0000 0000 0000 0009 0009 0009 0009 0009 0009 0009 0027 0000 0000 0000 0000 0027 0009 0009 0009 0009 0009 0009 0009 0009 0009 0009 0009 0009 0009
0009 0009 0009 0009 0009 0009 0009 0009 0009 0009 0009 0009 0009 0009 0009 0009 0009 0009 0000 0000 0000 0000 0000 0009 0009 0009 0009 0009 0009 0009 0009 0027 0027 0027 0027 0027 0027 0009 0009 0009 0009 0009 0009 0009 0009 0009 0009 0009 0009 0009
0009 0009 0009 0009 0009 0009 0009 0009 0009 0009 0009 0009 0009 0009 0009 0009 0009 0009 0000 0000 0000 0000 0001 0009 0009 0009 0009 0009 0009 0009 0009 0009 0009 0009 0009 0009 0009 0009 0009 0009 0009 0009 0009 0009 0009 0009 0009 0009 0009 0009
0009 0009 0009 0009 0009 0009 0009 0009 0009 0009 0009 0009 0009 0009 0009 0009 0009 0009 0000 0001 0000 0000 0009 0009 0009 0009 0009 0009 0009 0009 0009 0009 0009 0009 0009 0009 0009 0009 0009 0009 0009 0009 0009 0009 0009 0009 0009 0009 0009 0009
0009 0009 0009 0009 0009 0009 0009 0009 0009 0009 0009 0009 0009 0009 0009 0009 0009 0009 0000 0001 0000 0000 0009 0009 0009 0009 0009 0009 0009 0009 0009 0009 0009 0009 0009 0009 0009 0009 0009 0009 0009 0009 0009 0009 0009 0009 0009 0009 0009 0009
0009 0009 0009 0009 0009 0009 0009 0009 0009 0009 0009 0009 0009 0009 0009 0009 0009 0009 0000 0000 0000 0000 0009 0009 0009 0009 0009 0009 0009 0009 0009 0009 0009 0009 0009 0009 0009 0009 0009 0009 0009 0009 0009 0009 0009 0009 0009 0009 0009 0009
0000 0000 0000 0001 0000 0000 0001 0000 0001 0001 0000 0000 0000 0000 0000 0000 0000 0000 0000 0001 0001 0001 0001 0001 0001 0001 0001 0001 0001 0001 0000 0000 0000 0000 0000 0009 0000 0027 0027 0027 0027 0027 0027 0027 0027 0027 0027 0027 0027 0027
0001 0000 0000 0000 0000 0001 0001 0000 0000 0001 0000 0000 0000 0000 0000 0000 0000 0000 0001 0001 0027 0027 0027 0027 0027 0001 0001 0001 0001 0001 0000 0000 0000 0000 0000 0009 0009 0027 0000 0027 0000 0027 0000 0027 0000 0027 0000 0027 0000 0027
0001 0001 0000 0000 0000 0000 0001 0000 0001 0000 0000 0000 0000 0000 0000 0000 0001 0001 0001 0001 0027 0000 0000 0000 0027 0000 0000 0000 0000 0000 0000 0000 0000 0000 0001 0000 0000 0027 0001 0001 0000 0000 0000 0000 0000 0000 0000 0000 0000 0000
0001 0001 0001 0000 0001 0001 0000 0000 0000 0001 0000 0000 0000 0000 0000 0001 0001 0001 0001 0001 0027 0000 0000 0000 0000 0000 0000 0000 0000 0000 0000 0000 0000 0000 0001 0000 0000 0027 0027 0001 0000 0000 0000 0027 0027 0027 0027 0027 0027 0027
0001 0001 0001 0000 0000 0000 0000 0000 0000 0000 0000 0000 0000 0000 0000 0001 0001 0001 0000 0001 0027 0000 0000 0000 0027 0001 0000 0000 0001 0001 0000 0000 0000 0000 0001 0000 0000 0027 0000 0000 0000 0000 0000 0027 0000 0000 0000 0000 0000 0000
0000 0000 0001 0000 0000 0000 0000 0000 0000 0000 0000 0000 0000 0000 0000 0001 0001 0000 0000 0000 0027 0000 0000 0000 0027 0001 0000 0000 0001 0001 0000 0000 0000 0000 0000 0000 0000 0027 0027 0000 0000 0000 0000 0027 0000 0000 0000 0000 0000 0000
0000 0000 0001 0001 0000 0000 0000 0000 0001 0001 0001 0001 0001 0001 0000 0000 0001 0000 0000 0000 0027 0027 0027 0027 0027 0000 0000 0000 0001 0001 0000 0000 0000 0000 0000 0000 0000 0027 0000 0000 0000 0000 0000 0027 0000 0000 0000 0000 0000 0000
0001 0000 0000 0000 0001 0000 0000 0001 0001 0001 0001 0001 0000 0001 0001 0001 0001 0001 0001 0001 0001 0001 0000 0001 0001 0001 0000 0000 0001 0001 0000 0000 0000 0000 0000 0000 0000 0027 0027 0000 0000 0000 0000 0027 0000 0000 0000 0000 0000 0000
0001 0001 0000 0001 0001 0000 0000 0000 0001 0001 0001 0001 0000 0000 0001 0001 0001 0000 0000 0001 0001 0001 0000 0001 0001 0000 0000 0000 0001 0001 0000 0000 0000 0000 0000 0017 0018 0018 0018 0018 0016 0000 0000 0027 0027 0027 0000 0027 0027 0027
0000 0000 0000 0000 0000 0000 0001 0000 0000 0001 0001 0001 0000 0000 0000 0001 0001 0000 0000 0000 0001 0001 0000 0000 0000 0000 0000 0000 0001 0001 0000 0000 0000 0000 0000 0023 0000 0027 0000 0000 0014 0018 0018 0018 0018 0018 0000 0000 0000 0000
0000 0000 0000 0000 0001 0001 0000 0000 0000 0000 0001 0001 0001 0001 0000 0000 0000 0000 0000 0000 0000 0000 0000 0000 0000 0000 0000 0000 0001 0001 0000 0000 0000 0000 0000 0023 0000 0027 0000 0027 0000 0027 0000 0027 0000 0027 0000 0027 0000 0027
0000 0000 0000 0000 0000 0000 0000 0000 0000 0000 0000 0000 0000 0000 0000 0000 0000 0000 0000 0000 0000 0000 0000 0000 0000 0000 0000 0000 0000 0000 0000 0000 0000 0000 0000 0023 0000 0027 0027 0027 0027 0027 0027 0027 0027 0027 0027 0027 0027 0027
0029 0029 0029 0029 0029 0029 0029 0029 0029 0029 0029 0029 0029 0029 0029 0029 0029 0029 0029 0029 0029 0029 0029 0029 0029 0029 0029 0029 0029 0029 0029 0029 0029 0000 0000 0023 0000 0001 0000 0001 0000 0001 0000 0001 0000 0001 0000 0001 0000 0001
0009 0009 0009 0009 0009 0009 0009 0009 0009 0009 0009 0009 0009 0009 0009 0009 0009 0009 0009 0009 0009 0009 0009 0009 0009 0009 0009 0009 0009 0009 0009 0009 0009 0030 0000 0014 0018 0018 0018 0018 0018 0018 0018 0018 0018 0018 0018 0018 0018 0018
0009 0009 0009 0009 0009 0009 0009 0009 0009 0009 0009 0009 0009 0009 0009 0009 0009 0009 0009 0009 0009 0009 0009 0009 0009 0009 0009 0009 0009 0009 0009 0009 0009 0030 0000 0000 0000 0000 0000 0000 0000 0000 0000 0000 0000 0000 0000 0000 0000 0000
0009 0009 0009 0009 0009 0009 0009 0009 0009 0009 0009 0009 0009 0009 0009 0009 0009 0009 0009 0009 0009 0009 0009 0009 0009 0009 0009 0009 0009 0009 0009 0009 0009 0009 0029 0029 0029 0029 0029 0029 0029 0029 0029 0029 0029 0029 0029 0029 0029 0029
0009 0009 0009 0009 0009 0009 0009 0009 0009 0009 0009 0009 0009 0009 0009 0009 0009 0009 0009 0009 0009 0009 0009 0009 0009 0009 0009 0009 0009 0009 0009 0009 0009 0009 0009 0009 0009 0009 0009 0009 0009 0009 0009 0009 0009 0009 0009 0009 0009 0009
0009 0009 0009 0009 0009 0009 0009 0009 0009 0009 0009 0009 0009 0009 0009 0009 0009 0009 0009 0009 0009 0009 0009 0009 0009 0009 0009 0009 0009 0009 0009 0009 0009 0009 0009 0009 0009 0009 0009 0009 0009 0009 0009 0009 0009 0009 0009 0009 0009 0009
0009 0009 0009 0009 0009 0009 0009 0009 0009 0009 0009 0009 0009 0009 0009 0009 0009 0009 0009 0009 0009 0009 0009 0009 0009 0009 0009 0009 0009 0009 0009 0009 0009 0009 0009 0009 0009 0009 0009 0009 0009 0009 0009 0009 0009 0009 0009 0009 0009 0009
0009 0009 0009 0009 0009 0009 0009 0009 0009 0009 0009 0009 0009 0009 0009 0009 0009 0009 0009 0009 0009 0009 0009 0009 0009 0009 0009 0009 0009 0009 0009 0009 0009 0009 0009 0009 0009 0009 0009 0009 0009 0009 0009 0009 0009 0009 0009 0009 0009 0009
0009 0009 0009 0009 0009 0009 0009 0009 0009 0009 0009 0009 0009 0009 0009 0009 0009 0009 0009 0009 0009 0009 0009 0009 0009 0009 0009 0009 0009 0009 0009 0009 0009 0009 0009 0009 0009 0009 0009 0009 0009 0009 0009 0009 0009 0009 0009 0009 0009 0009
0009 0009 0009 0009 0009 0009 0009 0009 0009 0009 0009 0009 0009 0009 0009 0009 0009 0009 0009 0009 0009 0009 0009 0009 0009 0009 0009 0009 0009 0009 0009 0009 0009 0009 0009 0009 0009 0009 0009 0009 0009 0009 0009 0009 0009 0009 0009 0009 0009 0009
0009 0009 0009 0009 0009 0009 0009 0009 0009 0009 0009 0009 0009 0009 0009 0009 0009 0009 0009 0009 0009 0009 0009 0009 0009 0009 0009 0009 0009 0009 0009 0009 0009 0009 0009 0009 0009 0009 0009 0009 0009 0009 0009 0009 0009 0009 0009 0009 0009 0009
0009 0009 0009 0009 0009 0009 0009 0009 0009 0009 0009 0009 0009 0009 0009 0009 0009 0009 0009 0009 0009 0009 0009 0009 0009 0009 0009 0009 0009 0009 0009 0009 0009 0009 0009 0009 0009 0009 0009 0009 0009 0009 0009 0009 0009 0009 0009 0009 0009 0009
0009 0009 0009 0009 0009 0009 0009 0009 0009 0009 0009 0009 0009 0009 0009 0009 0009 0009 0009 0009 0009 0009 0009 0009 0009 0009 0009 0009 0009 0009 0009 0009 0009 0009 0009 0009 0009 0009 0009 0009 0009 0009 0009 0009 0009 0009 0009 0009 0009 0009
0009 0009 0009 0009 0009 0009 0009 0009 0009 0009 0009 0009 0009 0009 0009 0009 0009 0009 0009 0009 0009 0009 0009 0009 0009 0009 0009 0009 0009 0009 0009 0009 0009 0009 0009 0009 0009 0009 0009 0009 0009 0009 0009 0009 0009 0009 0009 0009 0009 0009
0009 0009 0009 0009 0009 0009 0009 0009 0009 0009 0009 0009 0009 0009 0009 0009 0009 0009 0009 0009 0009 0009 0009 0009 0009 0009 0009 0009 0009 0009 0009 0009 0009 0009 0009 0009 0009 0009 0009 0009 0009 0009 0009 0009 0009 0009 0009 0009 0009 0009
0009 0009 0009 0009 0009 0009 0009 0009 0009 0009 0009 0009 0009 0009 0009 0009 0009 0009 0009 0009 0009 0009 0009 0009 0009 0009 0009 0009 0009 0009 0009 0009 0009 0009 0009 0009 0009 0009 0009 0009 0009 0009 0009 0009 0009 0009 0009 0009 0009 0009
0009 0009 0009 0009 0009 0009 0009 0009 0009 0009 0009 0009 0009 0009 0009 0009 0009 0009 0009 0009 0009 0009 0009 0009 0009 0009 0009 0009 0009 0009 0009 0009 0009 0009 0009 0009 0009 0009 0009 0009 0009 0009 0009 0009 0009 0009 0009 0009 0009 0009
0009 0009 0009 0009 0009 0009 0009 0009 0009 0009 0009 0009 0009 0009 0009 0009 0009 0009 0009 0009 0009 0009 0009 0009 0009 0009 0009 0009 0009 0009 0009 0009 0009 0009 0009 0009 0009 0009 0009 0009 0009 0009 0009 0009 0009 0009 0009 0009 0009 0009

