5 5 4 5 5 5 5 5 5 5 5 5 5 5 5 5
5 0 4 0 0 0 0 12 10 13 5 0 0 0 0 5
5 1 4 1 0 0 0 11 0 11 5 0 0 1 0 5
5 0 4 0 0 0 0 4 0 14 10 0 0 1 0 5
5 0 4 0 0 0 1 4 0 0 5 1 0 1 1 5
5 0 4 0 0 0 0 4 0 0 5 0 1 0 1 5
5 1 4 0 0 1 1 4 0 0 5 5 5 5 5 5
5 0 4 1 1 1 0 4 0 0 1 0 0 0 0 5
5 0 2 6 6 6 6 7 6 6 6 6 6 6 6 6
5 0 1 1 1 1 1 1 0 1 0 0 1 0 0 5
5 0 5 0 5 0 5 0 5 1 5 0 5 1 5 5
5 5 5 5 5 5 5 5 5 5 5 5 5 5 5 5